%%%%
%  %
%  %
%P %
%  %
%  %
%%%%